0000000000000000000000000000000000000000000000000000000000000000
0000000000000000000000000000000000000000000000000000000000000000
0000000000000000000000000000000000000000000000000000000000000000
0000000000000000000000000000000000000000000000000000000000000000
0000000000000000000000000000000000000000000000000000000000000000
0000000000000000000000000000000000000000000000000000000000000000
0000000000000000000000000000000000000000000000000000000000000000
0000011111111111111111111111111111111111111111111111111111100000
0000011110000000000000000000000000000000000000000001000000100000
0000011110000000000000000000000000000000000000000001000000100000
0000011110000000000000000000000000000000000000000000000000100000
0000011110000000000000000000000000000000000000000000000000100000
0000011110000000000000000000000000000000000000000000000000100000
0000010000000000000000000000000000000000000000000000000000100000
0000010000000000000000000000000000000000000000000000000000100000
0000010000000000000000000000000000000000000000000000000000100000
0000010000000000000000000000000000000000000000000000000000100000
0000010000000000000000000000000000000000000000000000000000100000
0000010000000000000000000000000000000000000000000000000000100000
0000010000000000000000000011111111111000000000000000000000100000
0000010000000000000000000010000000001000000000000000000000100000
0000010000000000000000000010000000001000000000000000000000100000
0000010000000000000000000011111111111000000000000000000000100000
0000010000000000000000000000000000000000000000000000000000100000
0000011100000000000000000000000000000000000000000000000000100000
0000011111000000000000000000000000000000000000000000000000100000
0000011111000000000000000000000000000000000000000000000000100000
0000011111000000000000000000000000000000000000000000000111100000
0000011111000000000000000000000000000000000000000000000111100000
0000011111000000000000000000000000000000000000000000000111100000
0000011111111111111111111111111111111111111111111111111111100000
0000000000000000000000000000000000000000000000000000000000000000
0000000000000000000000000000000000000000000000000000000000000000
0000000000000000000000000000000000000000000000000000000000000000
0000000000000000000000000000000000000000000000000000000000000000
0000000000000000000000000000000000000000000000000000000000000000