00000000000000000000000000000000000000000000000000000000000000000000000000000000000000000000000000000000000000000000000000000000
00000000000000000000000000000000000000000000000000000000000000000000000000000000000000000000000000000000000000000000000000000000
00000000000000000000000000000000000000000000000000000000000000000000000000000000000000000000000000000000000000000000000000000000
01111111111111111111111111111111111111111111111111111111111111111111111111111111111111111111111111111111111111111111111111111110
01000000000000000000000000000000000000000000000000000000000000000000000000000000000000000000000000000000000000000000000000000010
01000000000000000000000000000000000000000000000000000000000000000000000000000000000000000000000000000000000000000000000000000010
01000000000000000000000000000000000000000000000000000000000000000000000000000000000000000000000000000000000000000000000000000010
01000000000000000000000000000000000000000000000000000000000000000000000000000000000000000000000000000000000000000000000000000010
01000000000000000000000000000000000000000000000000000000000000000000000000000000000000000000000000000000000000000000000000000010
01000000000000000000000000000000000000000000000000000000000000000000000000000000000000000000000000000000000000000000000000000010
01000000000000000000000000000000000000000000000000000000000000000000000000000000000000000000000000000000000000000000000000000010
01000000000000000000000000000000000000000000000000000000000000000000000000000000000000000000000000000000000000000000000000000010
01000000000000000000000000000000000000000000000000000000000000000000000000000000000000000000000000000000000000000000000000000010
01000000000000000000000000000000000000000000000000000000000000000000000000000000000000000000000000000000000000000000000000000010
01000000000000000000000000000000000000000000000000000000000000000000000000000000000000000000000000000000000000000000000000000010
01000000000000000000000000000000000000000000000000000000000000000000000000000000000000000000000000000000000000000000000000000010
01000000000000000000000000000000000000000000000000000000000000000000000000000000000000000000000000000000000000000000000000000010
01000000000000000000000000000000000000000000000000000000000000000000000000000000000000000000000000000000000000000000000000000010
01000000000000000000000000000000000000000000000000000000000000000000000000000000000000000000000000000000000000000000000000000010
01000000000000000111111111111111111111111111111111111111111111111111111111111111111111111111111111111111111111100000000000000010
01000000000000000100000000000000000000000000000000000000000000000000000000000000000000000000000000000000000000100000000000000010
01000000000000000100000000000000000000000000000000000000000000000000000000000000000000000000000000000000000000100000000000000010
01000000000000000100000000000000000000000000000000000000000000000000000000000000000000000000000000000000000000100000000000000010
01000000000000000111111111111111111111111111111111111111111111111111111111111111111111111111111111111111111111100000000000000010
01000000000000000100000000000000011000000000000000000000000000000000000000000000000000000000011000000000000000100000000000000010
01000000000000000100000000000000011000000000000000000000000000000000000000000000000000000000011000000000000000100000000000000010
01000000000000000100000000000000011000000000000000000000000000000000000000000000000000000000011000000000000000100000000000000010
01000000000000000100000000000000011000000000000000000000000000000000000000000000000000000000011000000000000000100000000000000010
01000000000000000100000000000000011000000000000000000000000000000000000000000000000000000000011000000000000000100000000000000010
01000000000000000100000000000000011000000000000000000000000000000000000000000000000000000000011000000000000000100000000000000010
01000000000000000100000000000000011000000000000000000000000000000000000000000000000000000000011000000000000000100000000000000010
01000000000000000100000000000000011000000000000000000000000000000000000000000000000000000000011000000000000000100000000000000010
01000000000000000100000000000000011000000000000000000000000000000000000000000000000000000000011000000000000000100000000000000010
01000000000000000100000000000000011000000000000000000000000000000000000000000000000000000000011000000000000000100000000000000010
01000000000000000100000000000000011000000000000000000000000000000000000000000000000000000000011000000000000000100000000000000010
01000000000000000100000000000000011000000000000000000000000000000000000000000000000000000000011000000000000000100000000000000010
01000000000000000100000000000000011000000000000000000000000000000000000000000000000000000000011000000000000111100000000000000010
01000000000000000100000000000000011000000000000000000000000000000000000000000000000000000000011000000000000111100000000000000010
01000000000000000100000000000000011000000000000000000000000000000000000000000000000000000000011000000000000111100000000000000010
01000000000000000100000000000000011000000000000000000000000000000000000000000000000000000000011000000000000111100000000000000010
01000000000000000100000000000000011111111111111111111111111111111111111111111111111111111111111000000000000111100000000000000010
01000000000000000100000000000000000000000000000000000000000000000000000000000000000000000000000000000000000111100000000000000010
01000000000000000100000000000000000000000000000000000000000000000000000000000000000000000000000000000000000000100000000000000010
01000000000000000100000000000000000000000000000000000000000000000000000000000000000000000000000000000000000000100000000000000010
01000000000000000100000000000000000000000000000000000000000000000000000000000000000000000000000000000000000000100000000000000010
01000000000000000100000000000000000000000000000000000000000000000000000000000000000000000000000000000000000000100000000000000010
01000000000000000100000000000000000000000000000000000000000000000000000000000000000000000000000000000000000000100000000000000010
01000000000000000100000000000000000000000000000000000000000000000000000000000000000000000000000000000000000000100000000000000010
01000000000000000100000000000000000000000000000000000000000000000000000000000000000000000000000000000000000000100000000000000010
01000000000000000100000000000000000000000000000000000000000000000000000000000000000000000000000000000000000000100000000000000010
01000000000000000100000000000000000000000000000000000000000000000000000000000000000000000000000000000000000000100000000000000010
01000000000000000100000000000000000000000000000000000000000000000000000000000000000000000000000000000000000000100000000000000010
01000000000000000100000000000000000000000000000000000000000000000000000000000000000000000000000000000000000000100000000000000010
01000000000000000111111111111111111111111111111111111111111100000000111111111111111111111111111111111111111111100000000000000010
01000000000000000110000000000000000000000000000000000000000100000000100000000000000000000000000000000000000000100000000000000010
01000000000000000110000000000000000000000000000000000000000100000000100000000000000000000000000000000000000000100000000000000010
01000000000000000111111111111111111111111111111111111111111100000000111111111111111111111111111111111111111111100000000000000010
01000000000000000000000000000000000000000000000000000111100000000000000011100000000000000000000000000000000000000000000000000010
01000000000000000000000000000000000000000000000000000111100000000000000000000000000000000000000000000000000000000000000000000010
01000000000000000000000000000000000000000000000000000000000000000000000000000000000000000000000000000000000000000000000000000010
01000000000000000000000000000000000000000000000000000000000000000000000000000000000000000000000000000000000000000000000000000010
01000000000000000000000000000000000000000000000000000000000000000000000000000000000000000000000000000000000000000000000000000010
01000000000000000000000000000000000000000000000000000000000000000000000000000000000000000000000000000000000000000000000000000010
01000000000000000000000000000000000000000000000000000000000000000000000000000000000000000000000000000000000000000000000000000010
01000000000000000000000000000000000000000000000000000000000000000000000000000000000000000000000000000000000000000000000000000010
01000000000000000000000000000000000000000000000000000000000000000000000000000000000000000000000000000000000000000000000000000010
01000000000000000000000000000000000000000000000000000000000000000000000000000000000000000000000000000000000000000000000000000010
01000000000000000000000000000000000000000000000000000000000000000000000000000000000000000000000000000000000000000000000000000010
01000000000000000000000000000000000000000000000000000000000000000000000000000000000000000000000000000000000000000000000000000010
01111111111111111111111111111111111111111111111111111111111111111111111111111111111111111111111111111111111111111111111111111110
00000000000000000000000000000000000000000000000000000000000000000000000000000000000000000000000000000000000000000000000000000000
00000000000000000000000000000000000000000000000000000000000000000000000000000000000000000000000000000000000000000000000000000000